000011001111111111000000000000000000000
002011001111111111000200000000000000000
000011441111111111441111111111111111111
000010000000000000000000000000100000000
000040000000000000000000000000100000000
000010000000000000000000000000100000000
300010000000111141000000000000144111111
000010000000100001000000000000400040000
000010000000100001000000000000400040000
000010000000144441000000000000144111111
000040000000000000000000000000100000000
111110000000000000000000000000100000000
000010000000000000000000000000100000000
000010000000000000000000000000111111111
000010000000000000000000000000100000000
000040000000000000000000000000100000000
111110000014441000000000000000400000000
000040000010001000000000000000400000000
000040000010001111444411441111111111111
000011114110001111000010000000000000000
000010000010001111000010000300000000000
000010000010001111000010000000000000000
000010000010001111000010000000000000000
111111111111111111000011111111111111111
