000011001111111111000000000000000000000
000011001111111111000000000000000000000
000011441111111111441111111111111111111
000010000000000000000000000000100000000
300040000000000000000000000000100000000
500010000000000000000000000000100000000
500010000000000000011111110000144111111
500010000000000000010000010000400040000
500010000200000000010000010000400040000
500010000000000000010000010000144111111
555555555000000000000000000000100000000
111110005000001000000000000000100000000
000010005000000000000000000000100000000
000010005000000000000000000000111111111
000010005000000000000000000000100000000
000040005000000000000000000000100000000
111110005014441000000000000000400030000
000040005010001000000000000000400000000
000040005010001111444411441111111111111
000011115110001111000010000000000000000
000010055010301111000010000000000000000
000010050010001111000010000000000000000
000010020010001111000010000000000000000
111111111111111111000011111111111111111
